100000000000000000000000000000000000000000000000000000000000
100000000000000000000000000000100000000000000100000000000011
100000000000100000000000000001111111100000001100100000000111
100000000001100000000000000111010100110000011100100000001111
100000000011100000000000111110010100011000111100100000011111
111111111111111111111111111111111111111111111100111111111111