100000000000000000000000000000000000000000000000000000000000
100000000000000000000000000000000000000000000000000000000000
100000000000100000000000000000000000000000000000000000000000
100000000001100000000000000000000000000000000000000000000000
100000000011100000000000000000000000000000000000000000000000
111111111111111111111111111111111111111111111111111111111111