100000000000000000000000000000000000000000000000000000000000
100000000000000000000000000000100000000000000000000000000000
100000000000100000000000000001111111100000000000000000000000
100000000001100000000000000111010100110000000000000000000000
100000000011100000000000111110010100011000000000000000000000
111111111111111111111111111111111111111111111111111111111111